 xx    x     x x  xx    x       xx x    
   xxxxx      x   xx x    x  x  x     x 
        xxx xx      x      xx   x       
    x xx x xx  x  x xx xx x    xxx x  xx
x x      x xxx    x x   x        x x    
    x x x x   x x     x  xx   xx x    x 
   x    xxxx  x xx               xx    x
 x  x     x           x  x    x   x  x  
   x xxxx       x        x   x    xxx   
   x xx  x               x  x  x    xx  
  xx           x      x x   x     x     
     x        x x      x     x x  xx   x
       x    x   x x          x  x xxx   
  x   xx   xx  x    x x    xx x         
x x  x  x     x x   x       x xx x  x   
 x x   x x xx    xx  x x  x x     x  xxx
x  xx     xxxxx   x           xx    xx x
 x    x     x     xx x x   x x       x  
   x     x xx x xx      x    x x x    x 
 x x x     xx        xxx xxx    x  x   x
x    xx     x         x x xx xxx        
 x  x x   x xx  x      xx       xx x x  
      x    x         x x     x  xx      
x    x                  x   x    x xx   
xx  x x xxx       xx                    
xx     xx  x  x  xx xx         xx     x 
       x x       x   x  xxx    xx  x xx 
 x   x           x        x x x         
    x x xx  x   xx  x  x x   x  x x   xx
 x  x xx  xx xx  x x  x x  x      x  x  
  xxx x  xx x x     x xx   xx x   xx xxx
xxx x         x   xx  x         x   x  x
xx      x     xx  xxx xx   x      x    x
 x xx x  x  x x      xxx  x   x      xx 
       xxx xx  x            x  x x x   x
x  x     x x x x   x  x        x    xx x
      x x x    x  xx  x     xx x x      
 x  x  x x xx x   x       x     xx    xx
  xx               x   x    xxx   x x   
 xx   x x x  xx x  x    x      x xx  xxx
